################################
#            *   *             #
#            *   *             #
#            *   *             #
#            *   *             #
#            *****             #
#                              #
#                              #
#    ****  *   * **** *  **    #
#    *     *   * *    * **     #
#    ****  *   * *    ***      #
#       *  *   * *    * **     #
#    ****  ***** **** *  **    #
#                              #
#                              #
#                              #
################################