#background:background-cosmic_enlarged.png
#music:megalovania_100bpm_remix.mp3
SSSSSSSSSSSSSSSSSSSSSSSSSSSSSSSSSSSSSSSSSSSSSSSSSSSSSSSSSSSSSSSSSSSSSSSSSSSSSSSSSSSSSSSSSSSSSSSSSSSSSSSSSSSSSSSSSSSSSSSSSSSSSSSSSSSSSSSSSSSSSSSSSSSSSSSSSSSSSSSSSSSSSSSSSSSSSSSSSSSSSSSSSSSSSSSSSSSSSSSSSSSSSSSSSSSSSSSSSSSSSSSSSSSSSSSSSSSSSSSSSSSSSSSSSSSSS
S                                                                                                                                                                                                                                                           S
S                                                                                                                                                                                                                                                           S
S                                                                                                                                                                                                                                                           S
S                                                           R                                                                                                                                                                                               S
S                                             G             R                                                                                                                                                                                               S
S                               B             G             R                                                                                                                                                                                               S
S  P                b           B             G             R                                                                                                                                                                                               S
S                   b           B             G             R                                                                                                                                                                                               S
S                   b           B             G             R                                                                                                                                                                                               S
SgggggggggggggggggggggggggggggggggggggggggggggggggggggggggggggggggggggggggggggggggggggggggggggggggggggggggggggggggggggggggggggggggggggggggggggggggggggggggggggggggggggggggggggggggggggggggggggggggggggggggggggggggggggggggggggggggggggggggggggggggggggggggggS
SKKKKKKKKKKKKKKKKKKKKKKKKKKKKKKKKKKKKKKKKKKKKKKKKKKKKKKKKKKKKKKKKKKKKKKKKKKKKKKKKKKKKKKKKKKKKKKKKKKKKKKKKKKKKKKKKKKKKKKKKKKKKKKKKKKKKKKKKKKKKKKKKKKKKKKKKKKKKKKKKKKKKKKKKKKKKKKKKKKKKKKKKKKKKKKKKKKKKKKKKKKKKKKKKKKKKKKKKKKKKKKKKKKKKKKKKKKKKKKKKKKKKKKKKKKKS
SKKKKKKKKKKKKKKKKKKKKKKKKKKKKKKKKKKKKKKKKKKKKKKKKKKKKKKKKKKKKKKKKKKKKKKKKKKKKKKKKKKKKKKKKKKKKKKKKKKKKKKKKKKKKKKKKKKKKKKKKKKKKKKKKKKKKKKKKKKKKKKKKKKKKKKKKKKKKKKKKKKKKKKKKKKKKKKKKKKKKKKKKKKKKKKKKKKKKKKKKKKKKKKKKKKKKKKKKKKKKKKKKKKKKKKKKKKKKKKKKKKKKKKKKKKKS
S                                                                                                                                                                                                                                                           S
S                                                                                                                                                                                                                                                           S
S                                                                                                                                                                                                                                                           S
S                                                                                                                                                                                                                                                           S
S                                                                                                                                                                                                                                                           S
S                                                                                                                                                                                                                                                           S
S                                                                                                                                                                                                                                                           S
S                                                                                                                                                                                                                                                           S
S                                                                                                                                                                                                                                                           S
S                                                                                                                                                                                                                                                           S
S                                                                                                                                                                                                                                                           S
S                                                                                                                                                                                                                                                           S
S                                                                                                                                                                                                                                                           S
S                                                                                                                                                                                                                                                           S
S                                                                                                                                                                                                                                                           S
S                                                                                                                                                                                                                                                           S
S                                                                                                                                                                                                                                                           S
S                                                                                                                                                                                                                                                           S
S                                                                                                                                                                                                                                                           S
S                                                                                                                                                                                                                                                           S
S                                                                                                                                                                                                                                                           S
S                                                                                                                                                                                                                                                           S
S                                                                                                                                                                                                                                                           S
S                                                                                                                                                                                                                                                           S
S                                                                                                                                                                                                                                                           S
S                                                                                                                                                                                                                                                           S
S                                                                                                                                                                                                                                                           S
S                                                                                                                                                                                                                                                           S
S                                                                                                                                                                                                                                                           S
S                                                                                                                                                                                                                                                           S
S                                                                                                                                                                                                                                                           S
S                                                                                                                                                                                                                                                           S
S                                                                                                                                                                                                                                                           S
S                                                                                                                                                                                                                                                           S
S                                                                                                                                                                                                                                                           S
S                                                                                                                                                                                                                                                           S
S                                                                                                                                                                                                                                                           S
S                                                                                                                                                                                                                                                           S
S                                                                                                                                                                                                                                                           S
S                                                                                                                                                                                                                                                           S
S                                                                                                                                                                                                                                                           S
S                                                                                                                                                                                                                                                           S
S                                                                                                                                                                                                                                                           S
S                                                                                                                                                                                                                                                           S
S                                                                                                                                                                                                                                                           S
S                                                                                                                                                                                                                                                           S
S
S
S