#background:background-cosmic.png
#music:megalovania_100bpm_remix.mp3
GGGGGGGGGGGGGGGGGGGGGGGGGGGGGGGGGGGGGGGGGGGGGGGGGGGGGGGGGGGGG
G          G          G        G                            W
G          G          G        G                            W
G          G       G  G  GGG   G   G                        W
G         GGG      G  G    G   G   G                        G
G          G       G  G    G   GG  G                        G
G   GGGG   G   GGGGG  GGGG G   G   G                  GGG   G
G      G   G       G       G   G   G                        G
G      GG  GGG     G       G   G  GG  GGG                   G
GGGGG  G    G      GGGGGGGGG   G   G               GGG      G
G      G    G      G           G   G      GGG               G
G      GGG  GGGG   G           GG  G                        G
G      G      G   GG    GGGGGGGG   G           GGG          G
G    GGG   DD G    G               G                        G
G     G   GGGGGGG  G               G                        G
GG    G            G    D    GGGGGGG                        G
G     G            G    G    G                              G
G P   G            GDD  G    GDDDDDDDDDDDDDDDDDDDDDDDDDDDDDDG
GGGGGGGGGGGGGGGGGGGGGGGGGGGGGGGGGGGGGGGGGGGGGGGGGGGGGGGGGGGGG